# # # # #
#   B . #
#   P   #
#   .   #
# # # # #
