# # # # # #
# .     . #
#   B B   #
#   P     #
#         #
# # # # # #
