# # # # # # #
# .   B   . #
#     #     #
#   P   B   #
# # # # # # #
